odd  AA D
at AE T
hut	HH AH T
ought	AO T
cow	K AW
hide	HH AY D
be	B IY
cheese	CH IY Z
dee	D IY
thee	DH IY
Ed	EH D
hurt	HH ER T
ate	EY T
fee	F IY
green	G R IY N
he	HH IY
it	IH T
eat	IY T
gee	JH IY
key	K IY
lee	L IY
me	M IY
knee	N IY
ping	P IH NG
oat	OW T
toy	T OY
pee	P IY
read	R IY D
sea	S IY
she	SH IY
tea	T IY
theta	TH EY T AH
hood	HH UH D
two	T UW
vee	V IY
we	W IY
yield	Y IY L D
zee	Z IY
seizure	S IY ZH ER
